SO ./texture/redbrick.xpm
F 12,255,12

NO ./texture/bluestone.xpm
EA ./texture/mossy.xpm
WE ./texture/colorstone_1.xpm
C 0,128,255

11111111111111111
10000000000000001
10100000100000101
10000000000000001
10001000100010001
10000000010000001
10101010E01010101
10000000000000001
10000000000000001
10000000000000001
10100010000001001
10000000000000001
11111111111111111