F 0,2,209
SO ./texture/brick.xpm
WE ./texture/exit.xpm
EA ./texture/pwall.xpm
NO ./texture/pwall.xpm
C 225,30,0

      1111111111111111111111111
1000000000110000000000001
     1011000001110000000000001
10010000000000W0000000001
111111111011000001110000000000001
1000000000110000011101       11111111111