F 0,2,255
SO ./texture/brick.xpm
NO ./texture/floor.xpm
EA ./texture/pwall.xpm
C 233,0,12

WE ./texture/exit.xpm

1111111
1000001
1000001
1000W01
1111111