F 0,2,255
SO ./texture/brick.xpm
NO ./texture/floor.xpm
EA ./texture/pwall.xpm
C 233,0,12

WE ./texture/exit.xpm

111111
110001
100011
100N11
111111