F 0,2,225
SO ./texture/brick.xpm
NO ./texture/floor.xpm
WE ./texture/exit.xpm
EA ./texture/pwall.xpm
C 233,0,12

1111
1W0  1  
1
1111
