F 0,2,209
SO ./texture/brick.xpm
WE ./texture/exit.xpm
EA ./texture/pwall.xpm
NO ./texture/pwall.xpm
C 225,30,4


    1111111111111111111111111
   1000000000110000000000001
10110   00001110000000000001
1001000000000000000000001
11111111   1011000001110000000000001
100000000011000001110111111111111
11110111   111111011100000010001

11110111111111011101010010001
11000000110101011100000010001
10000000000 000001100000010001
10000000000000001101010010001
11000001110101011111011110N0111
11110111 1110101 101111010001
11111111 1111111 111111111111

1111
1001 111
1111   101
    111
