NO ./texture/stars2.xpm
EA ./texture/sand.xpm
WE ./texture/planet.xpm
SO ./texture/stars.xpm

F 242,209,107
C 0,0,0

  111111111111111
111000000000001
100000100001111
100N00000110011
100000000000001
100100010000001
100000000000001
111000000000111
111111111111111