SO ./texture/redbrick.xpm
F 12,255,12

NO ./texture/bluestone.xpm
EA ./texture/mossy.xpm
WE ./texture/colorstone_1.xpm
C 0,128,255


  111111111111111
111000000000001
100000100001111
100S00000110011
100000000000001
100100010000001
100000000000001
111000000000111
111111111111111