NO ./texture/greystone.xpm
EA ./texture/redbrick.xpm
WE ./texture/wood.xpm
SO ./texture/space.xpm

F 102,51,0
C 51,153,255


  111111111111111
111000000000001
100000100001111
100N00000110011
100000000000001
100100010000001
100000000000001
111000000000111
111111111111111
